1111111111111111111111111111111111
100000000000000000000000000000P001
1000000000000000000000000000000001
1001000000000000111111100000000001
1001000000000000000001100000000001
1001001000000000000110000000000001
10010010000000000011000000C0000001
1001111111000000011111111000000001
1000001000001000000000000000000001
1000001000010010000000000000000001
1000000000010011111110000000000001
1000000000010000E00111000000000001
1000000000010111111111111111111101
1000000000010000000000000000000001
1111111111111111111111111111111111
