111111
100001
101101
1001E1
110111
1P0111
1100C1
111111